WWWWWWWWWWWWWWWWWWWWWWWWWWWWWWWWWWWWWWWW
WU     W   WW        WW  W W    WWWW   W
WWW WW  W    W  W  W    WWW WWWW   W   W
W   W      WW   E WW WDW W   W  W W W WW
WWW   W WW       W     W W    WWW  W   W
W WWW W W   WW    W WW    WWW W  WWWW  W
W WWWW WWW   W WWW  W W W  WW  WWWWW   W
WW WWW        W  W W WW W   WW W  W  W W
WW W  W       WW   WWWWW     WWW   WWWWW
W  W  W WW  WW  W W W   W W  W W    WWWW
W  W  W WWW      W W  WWWW WWWW     WWWW
W WWWW  W     WWWWW WWW WW  W       W  W
W      W   WW W W    W W  W  WWWWW     W
W    WWW WW  WW   W     WWW   W   W W WW
WW   W  W W W  W W  W     WW  W   WWWWWW
WW  WW   W WW       W  W     WW W  WWWWW
WWWWW      W WW     W      W       W W W
W W   WW           W     W  W    WWW  WW
W    WW W   WW  WW W W WW W   W        W
WW W     WWW W W W  WWW  WW W  WW  WWWWW
W        W W       W    WW   WWWWW W   W
W WW  W W  W WWWW      WWWWWW      WWWWW
W W W   W     WW    WW W  W  WW  W W   W
W   WW        W WW    W  WW W W W  WWW W
W  W   W      W WW  W WW  WW W    WWWW W
WW WW  WW    W    WW  WW  W    W       W
W       W W  W  W W     WWWW  W WW W W W
WWW W  W    WW   W  W W W  W     W W   W
WW  W       W W  W  W  W  W W    W WW WW
W  W  W     W  H WWW   W W     WW    W W
W   WWW  WW     WWW    W  WWW     W W BW
W  WW  WW WW W WO W       WW       WWW W
WW  W   W W   WW W  W   W    W    W  WWW
WW W   W       WWW     WW WWWWW  W     W
WW WW  W      W    W W   W W W W  W  WWW
W W  W W     W    W W   W  W  W W WW   W
WWWWW WWW  W WW   WWWWWS      W W W W WW
WW   W    W W  W W     WW   W  W W   W W
W   W W   W WW     WW W  WW  WW  W W   W
WWWWWWWWWWWWWWWWWWWWWWWWWWWWWWWWWWWWWWWW
