WWWWWWWWWWWWWWWWWWWWWWWWWWWWWWWWWWWWWWWW
WU  WW     W W  WW   W   WWWW WW WW    W
W   W   W     WW W  WW WW W W W W   W WW
W      WW W     W   W W      W  W    WWW
WWW W  W W   W       WWWW WW WW   W    W
WW    WW    W  W WW W  WWW    W        W
WW     W WWHW  W WW W W WW  W    WW W  W
WW   W   W   W W  WWWWW   W            W
WW  WWW W   WW        W  WW W   WW W   W
W  W W  WW WWW WW    W        WW WW  W W
W  W  W  W SW  W  W   W     W  W  WW  WW
WW   WWW   W W WW     W  W   W    W WW W
W WW     W WWW  W W  WW   W WW W       W
W    WWO   W   W W      WW  W  W  W    W
WW WWWW    W     WW WW W W W WWW   WW WW
WW   W W  WW  W   W   W WW   WWWWW  D  W
W       W   WW WWW      W    W     WW WW
W  WWW  W W  W W       WW  WW   W WWWWWW
W  W  WW WW  W W W     W  W    W   WWW W
WWW W WW  WW    W WW      WW   W    W  W
WWW   W    W           W  W WW WW  W W W
W    W     WW WWW     W  WWWW W  W WW WW
W W    WW   W WW  WW     WW W W  W WW  W
W WWWWW  WWW WW  W  W      W  W       WW
WWW  WW  W   WW  WW        EW  W W  W WW
W  W  W    WW W   WWW      WWW    W   WW
W  W W  WW WW  W      WWW WW   W  WWWWWW
WWWWW  W W    WWWW          WW W     WWW
W  W     W  W WW   W   W  W  WW  WW    W
W     W W      W  WWW W  WWW W  W  WW  W
W  WWW WW  W  W     W W  W WWW       WWW
W W  W  WWW  W WW          W W       WWW
WW W WW WWWW   W   WW WW W   W   WWWWWWW
W W   WWW  B W W         WW  W   W    WW
W WW   WW W  WWWWW  W W W  WW W      W W
WW W             WWWW       WWW     W  W
WW   W  W WW W W WWWW W  W          W  W
W   W    W     W        W  WW  WW      W
W     WWW W    WW   W     W WW   W   W W
WWWWWWWWWWWWWWWWWWWWWWWWWWWWWWWWWWWWWWWW
