WWWWWWWWWWWWWWWWWWWWWWWWWWWWWWWWWWWWWWWW
WUWW W W   WW   W           W  WW      W
WW    WW  W WW     WW W     W    W W   W
WWW W     W     WW     D  W W W   W    W
W  W      W   W WWWWW W WW WW W   W   WW
WW   W        W  W  W     WW W W W W   W
W     W WW  W WW  W W    WW  WWW  W  W W
W  W   W  WW     WW    O    W   WW   W W
WW    W WWW WW WWWWW   W W  W      W   W
W    WWW WW W  W  W   WW WW WW   W     W
WW W  W   WW  W     WW     W W    WBWW W
W  W  W WW W    WW WW W  WWW      WW W W
W     WW    W W   W W   WWWW W WW      W
W        W W  WWW W WWW WW   WWW W   W W
W     W              WW    W    W W   WW
WW   WW     WW      W     W            W
WW  W W WW  W      WW  W      W W      W
W  W  WW   WW W W W    WWW     W  W    W
W    WW    W W    W W W  WW     WWW   WW
W       W          W    WW W     W WW  W
W  W  W          WW   W      WW   W  W W
WWW   WW    W WW W W       W  WW   W WWW
W W     W W W  W WW  W WW    W  W WWW WW
WW  W          WW   WWWW   W  WW WWWW WW
W W     W   W    W WW    WWS    WW W   W
W W      WWWW      WWW  W WW  W  WW    W
W  W    W    W  WWW       W       W    W
WW W WW  W W  WWW   W   W W WW W WE W WW
W WW  WW     W  WW W    W     W W  W   W
WW       W     W  W W    WWW WWW W   W W
W W    WW      W  W              W W   W
WW         W     W  W    W  WWW     WWWW
W  W WW   W W   H     W  W WWWWWW      W
W        W W                WWW     W WW
W  W WW    W   W  WW   WW W W     W W WW
W    W W W  WW W  W W W W  WW   W W W  W
W   WW WWW WW WW  WWWW    WWWWWW     WWW
WWWWWW      W  WW WWW     W   WWWW    WW
W     W WWW  W          W W    W  W   WW
WWWWWWWWWWWWWWWWWWWWWWWWWWWWWWWWWWWWWWWW
