WWWWWWWWWWWWWWWWWWWWWWWWWWWWWWWWWWWWWWWW
WUW  W W W H S    W   WW WWWWW  W W   WW
W W W W   W    W   W   W WW W  WW  W   W
W  W  WWWW  W  WWW   W     W  W W   W  W
W  W WWW WW    W  WW  W W  W WW  WW WW W
WW    WWW  W W     WW     W  W W    W  W
W W W    WW  WWW W W    W W W  WW W W  W
W  W  W  W  W      W W WWW WW  WW W   WW
W            W   W W W   W    WW  W W  W
WWW W    WW W  WW  W W W WWWW W W   WWWW
W   WWW WWW W       W W  W W WW  W WW  W
WWWW  W     WW W W  W    W WW W   W  WWW
W  W W WW      WW    W      W   W    WWW
WWWW  W   W WW         W  W WW   W   W W
WW W  W  W  WWW       WW   W W W W     W
W  W  WW   WW  W W WWWW  WW  WWW WW W  W
WW  W W WWWW   WW    W   W W  WWW W    W
WW W       W   WW    W     WWWWW WWW WWW
WWW WW  W   W WW W         WWWW  W WW WW
WW W  WW         WW  W     W W WWW WW  W
WW   WW W   W    W W  W   W W     W W  W
WW  WW      WWW W     W   W WW   BWW  WW
W    W           W       WW WW W W     W
W      WW    W  W W W W  W W   WWW W W W
W W W WWWWW WWWW    W WWWW  W  W   WWW W
WWWW  WWW WWW W   W W W  WWW  WWWWWWW WW
WW  W WW         W WW       W  W       W
W  W  WW     WWW W    W   W  WW WW  WW W
W  WW W     W   WW   WWW     WW W     WW
W     W      W   W     W W  W   W W W WW
W W WW              WWW W   W       W  W
WWWWW   WW   W     W  WW  W   W W W W  W
W     WW W W  WW  W WW  WW  WWWW   W   W
W W     W  W    W  W W W   WWW    W    W
WWW O   W  W W  W WWW     W    W   W  WW
WWWW  W WWEWW   W  WW  W   W WW        W
W            W W W   WW W   WWW      W W
WWW    WW WWW    W W  W  WW      WWWD  W
W   WW  WW W      W   WW  W W     W W WW
WWWWWWWWWWWWWWWWWWWWWWWWWWWWWWWWWWWWWWWW
