WWWWWWWWWWWWWWWWWWWWWWWWWWWWWWWWWWWWWWWW
WU W  W  WWW WW  E  WW     W   WWW  WW W
W     W   W W    W WW    WW         WW W
WW  W     WW  W    WW         W WWWW  WW
W    WW W       W    W    W W W    W W W
WW      WW      W      WW   W WW  W   WW
WW W WW    WW  W  WW     W  W    W W W W
W W  W W W W WW  W  W  W   WW     WWHW W
W     W   W  W W        W WW  W  W   W W
WWW     WW      W  WW    W  W   W      W
W  W W  WW  WWWW  W     WW    W W   WW W
W   W   W    W W W W W   WW WWWW WW    W
W S  W  W W      WW     WWW    WWW   W W
W  W  WW  WW WW   W W   W   WW  W WW   W
W  WW    WW  W W   W   W  WWW   WWWWW  W
WW W W W      W     W     W            W
WW    WW WW  WW  W WWW  W  W     WWW   W
W    W   W WWW   WW     WWW      W WW WW
WW  W        WW W  B WW   W  WW  WW  WWW
W W  W        W  WWW  WW  W W  W   W  WW
W WW   W WW  W       W W W  WW      W WW
WW   W W  W     W   W W    WW W      W W
W  W    W     W  WWW       WW WWW  W   W
WWW   W   W          W WW WWWW    W    W
WW    WW  W WW    W WO   W W W  W      W
W  WW W     W  WWW          W W W   W  W
W  W  WW     WW  W W       W W   W    WW
W    W  WW WWW     WW W W   W    W    WW
WW        W WW  W W                WWWWW
W   W WWWWW  WW     W W W  W W    WW   W
W  W W     WW     WW W         W WW W  W
W          W  W     W   W    W WW     WW
W   W  W  W         W  WWWW   WW   W   W
W W    W W W W W   W W   WW W     W    W
W WW  WW     W  WW       W  W  WWW W W W
W D    WW  W    W         W   W W W    W
WW W W    W       WWW W W W  WW      WWW
WW  W                WW   W WWW WW WW  W
WW   W   W WW   W         W WW      W  W
WWWWWWWWWWWWWWWWWWWWWWWWWWWWWWWWWWWWWWWW
