WWWWWWWWWWWWWWWWWW
E  WWWW    O     W
W  DWWW  WWWWWW  W
W      WW      B W
W  WW      WWWW  W
WWWWWDWWWK     DWW
W     WWW  WW    W
W  WWWW    HWWW  W
W      SWWW     UW
WWWWWWWWWWWWWWWWWW
