WWWWWWWWWWWWWWWWWWWWWWWWWWWWWWWWWWWWWWWW
WUW W  W  W WW W      W    SW W  W  W  W
W  W W W    WW              WW   W     W
W       W W  WW WW          WW   WWWW  W
W W   W W WW     W W  WWW   W  W W  WWWW
WW  WWW     W W  W W W W         WWWW  W
W W   W W W  W   W  WW     W    WWWW WWW
W   W  W     W W    WW W WW   W WB     W
WWW WW   WW WW WW W  WW W WH WW   WW W W
W    W        WW W  W WW W   W WW WW   W
WW WWW   WW  WW  WW W WWWW WWW     WW  W
W WW   W WW WW W   W W W W      W W WW W
W WWW WW  W WWW  W  WWW WW W W    W W  W
W  WW  WW W     WW W  W W WW       W  WW
W W W  W    W W  W    W W WWWWW  W WW WW
WW   W  WW W     WWWWW W      WW W    WW
W  WW W  W WWW W  W   WW  W   W        W
W W         WW  WW    W W WW  W W   WW W
W WW    WWWW  W  W  WWWWWW WW   W  W  WW
W  WWW    W    W W   W  W      W W W  WW
WW   WWW  W     WW      WWW W    WWW WWW
W W W W WW         W W   W      W  W W W
WWW  WWWW   WWWW W WW W  W W       W  WW
WW W W W W      W   W WW   W WW        W
WW W W    WW  W W    W   W  WW WW W  W W
W  WWW  WWWWW WW W W   W      W W   WW W
W   W          WW W   WWWWW W  WW  WW  W
W  W  W  W W   W   WWW W   W       W  WW
WWW      WW   W WWW   WW  W W   WWWW   W
WW W E WW W         WWW    W  W W W WW W
WW W    W  WO  W  W W   W WW    WWWW  WW
W       W     W WW    WWWWWW WWWD W    W
WW WWWWWWWWW     WW  W   W W     W  W  W
WW  W  W     WW  W W   W     W        WW
WWW  WWW  WW W     W  W   W            W
WW    WW   WW   W  WW W    W W WWW W W W
WW W   W    WWW W W   WWW         W W  W
W W  WW  W W   W    W W    W   WW  W   W
WW  WW  W W          W WW      W     W W
WWWWWWWWWWWWWWWWWWWWWWWWWWWWWWWWWWWWWWWW
