WWWWWWWWWWWWWWWWWWWWWWWWWWWWWWWWWWWWWWWW
WU   WW W W    W  W       W W   WWW   WW
WW   W  WW  W   W  W   W W W W  WW  W  W
W WW W  WWWW W     W W   W     WW   WW W
W   W      W  WO    WW  W  W   WWW W W W
W W    W BW W  W      WW   WWW   W W   W
W  W    W        W WWWW W   W W   WWWW W
WWW     W W  WW           WW         WWW
WW  WWW          WW WW   WWWW WW W WW WW
WW     W W       W       W        WW W W
W  W  W  W W      W     W  W        W  W
WW W         W     W   W WW D    W  W WW
WW   W            W  W  WW            WW
W  WW  W      WWW WW   W      WWWW  W WW
WWWW        W  WWW W WWW W W   W   W WWW
W      W  W    WW WW   WWWWWW  W W W   W
W  W      WW  W  W  W  W   W  W W  W  WW
W  W W   W WW WW  W WWW  W  W  W   W  WW
W  WW W  WWW        WWWWW    W  W      W
WW  W  W W WW  WW WW   W   W W WWW  W  W
W      W   W  W W        W WW  W W     W
W WWW  W H    WW WW       W  W  W W WW W
W  W WW     W    W  W  W    W  WW  W  WW
W    W    W WW    WWW  W  W    W  W    W
WW   WW W W    WW WW  W         W W W WW
WWWW    W  W W W   W    WWW WW   W WW  W
WW  W W   WW  WW     WW   W   WW    W  W
W       W  W    W W W        WW  W  WWWW
WW W W   W W W         W   W    WWWW W W
W  WW     WW  WW   WW  WW  WW  WW W    W
WW      W   W   W W    WWWWWWW  W   WWWW
W W W W  W       EW         W      W   W
W  W        W  WSW  W W  W      W  W   W
W  W W   WW     WW      W    W   W    WW
W   W  W  W   W W       WWW W  W       W
W     W WWW  WWWW  W        W W  W     W
W W        WW  W WW  W WW W      W    WW
WW       W    W WW W    W W     WW     W
WW    WWW         W   W W   W WWW  WWWWW
WWWWWWWWWWWWWWWWWWWWWWWWWWWWWWWWWWWWWWWW
