WWWWWWWWWWWWWWWWWWWWWWWWWWWWWWWWWWWWWWWW
WU WW     WWW       W      WW W   W  W W
WW   WW    WW W W    WWW WW W    WWW W W
WW   E      WWW  WWWWWW W W  W  W W  WWW
W   WWWW W W W  W   W W    W  W W WWW  W
W  W     W     W   WWW      W     W   WW
WWW    WWW  W    WW   WWWW   WWW WWW W W
WWWW     W W W  W W  W W   W   WWW WW  W
W    WWWWW  W       W   W    W WW W    W
WW WW  W   W  W    W  WW WW  WW     WW W
W    W    W  W  WW           WW W  WW  W
W  W  W    WWWW   WWWW    WW W W   W   W
W W   WWWWW WWWW       WW    W    W  WWW
WW  W   W   W W   W W WW   WWW      W  W
WW WW  WW      W W   WW W   W   W     WW
W W  W    W W WW  W S   WW W    WW    WW
WWWW  W WWW  W    W W      W    WWW  W W
W  W     WWWWWWWW  W W     W   W WW WWWW
WW WW     WWWW  W W     WWW      WWWW  W
W   W   W W    WW  W WW W   WWW  WW   WW
WWW W WWWW   W     WWWW     W W   WWWWWW
W W W W  WW  W    W     W    W   W WWWWW
W   W WW W    WW W WW H WW  W W  W  WW W
W   W W W W  W  WW      WW W    B W W  W
W    WW WD    WW    W   W  WW W W W WWWW
WW       WWW W WW W WW WW    WWW WW W WW
WW  W W WW  WW WWW  WW  W WW  WW       W
WWWW W  W                W  WWWW W W  WW
W        WW   W W    W   W    WWW  W   W
W W  WWW WW W  W   W    WW       W   W W
WWW WW  WWW        W     WW  W         W
WW W   WW    W  WW W  W     W  WW W W WW
WW  WW   W W       WW  W   W WWWW W  W W
W    WW WW WW  WW  W WW        O    WWWW
W   W    W    WW W        W W W   WWWWWW
W   W WWW W    WW W  W W    W    W  W  W
W WW  W   WW  WW W  W WWWW WW  W   W   W
W    W W   WW   WWW WWW  W W         WWW
WW  W  WW W WW    WW         WW  W   W W
WWWWWWWWWWWWWWWWWWWWWWWWWWWWWWWWWWWWWWWW
