WWWWWWWWWWWWWWWWWW
   WWWW    O     W
W  WWWW  WWWWWW  W
W      WW      B W
W  WW      WWWW  W
WWWWWDWWWK     WWW
W     WWW  WW    W
W  WWWW    HWWW  W
W      SWWW     UW
WWWWWWWWWWWWWWWWWW
