WWWWWWWWWWWWWWWWWWWWWWWWWWWWWWWWWWWWWWWW
WUW       W    WW WWWWWWWW     W  WW  WW
W   W WW    W  SW     WW    W   W W    W
W  W W         W W      WW WW WW W W W W
W    W  WWWW      W    W    WW  W  W   W
W   WWWWW    WW  WW        W    W    W W
W          WWW W     W W WWWW   W      W
W    W  W    W W WW   W  W     W  W WW W
W W W  W      WBW W      WW W W W WW  WW
WW WW W  W WWW   W   WWWWW          W WW
WW  W   W    WW W W   WW    W     W    W
WWW W W  WWWWW  W WE W  W W      WWW   W
W  WW  W     WW    W    W    WW        W
WW H   WW W WWWWWW WW   WWW W   WWW    W
WWWW W  WW  W    W  WWWWWW   WWWW WWWW W
W W  WWWW   W WW   W W W W  W WW    WW W
W WW  W   W WW   W  WWW  W   W  W W    W
W   W       WWWW   WW W WW  WWW W  W WWW
WWW    WWW    W WW WWW W      WWWW W   W
WWW WWW W  WW WW       WWW     WW   W  W
W  W             W W  W   W     WW   WWW
W W  WWWWWWW  W WWWW  W    W    W  W W W
W   WW W W     WOWW W      W     WW W  W
W  W   WW    W W  WWW WW    WW WWW    WW
W  W WWW          W   W  W W W       WWW
W  WW       W WW W  W    WW            W
W WW W  WWWW WW WW    W   W   WW   W WWW
W W     WWW WW WW W    WW W    WW  W W W
WWW       W       WWW          WW WW  WW
W W     WWW WW    WWWW W    W   WWW WW W
W  W  W W WWW    W W  W W  W      W W  W
WW WW W WW W     W   W  W W    W   W  WW
WW W  WWW   WW WWWWW  W WW WWWWW W   W W
W    WW  WW  WW  WWWW  WWW  W WWW     WW
W W  W           W     W WW   WW    WW W
W W W    W WWW     W  W   W   WW W     W
WW WWW  WW  WW WW  D   W   W   W  W W  W
W   WWW       W W WW  WWWWW   W    W  WW
WW W    W W  WW W  WW WW WW WWW W  WWWWW
WWWWWWWWWWWWWWWWWWWWWWWWWWWWWWWWWWWWWWWW
