WWWWWWWWWWWWWWWWWWWWWWWWWWWWWWWWWWWWWWWW
WU   W  W W   W  W      WW     W   EWWWW
W  WW W  WW         WWW WW     W  W    W
W   W  WWWW WW W W           WWWW  W   W
WW  W WW  W W W W H  W   W    WWWWWW   W
WW  W  W  WWW  WW W  W  WW   W W     W W
WW             W  W W  W W W      W    W
W W WWWW   W WW  WW W W      W  W WW W W
W    W WWWW W   W W     W  W   W      WW
W    WW   W    WW         WWW  W    WWWW
W   WW     WW   W W W  W     W  WW W WWW
W      W W W  W  W  W W   W   WW      WW
WW  W  W  W  W   W     WW WW     W   W W
W W     W W W W   W  W  WW  W  WWWW  WWW
W      W         W  WWW  W  W  W       W
W W     W    W WWW   W W W WW       W  W
WWW            WW W        W   WW W    W
W    WWWW  W  W W    W      B  W W   WWW
W  W W W  W        W W WW WW  W WW W   W
W       W  W    W  WW W W WW   WW  WW  W
W WW   W  W WW    W W W  W  WWW    WWWWW
W  W    WWWW W W       W WW W WW     WWW
W  W   WW W   W W W WWWW   W   W  WW W W
WWW  WWW   W WWW  W WWW   W   W      WWW
WWWWW    W     W W  WW   W   W W    W WW
W  WW   W   WW    W    WW  W WW W     WW
W  WWW  WWWW         W  WW  W        W W
W  WW   W  W   W   W W W  WW W   WWWW  W
W     W    W W W  WW    W  W W      WW W
W    WWW  W  W    W       W        W   W
WWW WWW       W    W  WW   W  W   WWW  W
WW   W   W   WW  WW    W      W W  W W W
W   WW   W W    WW  W WWW  W    W WWWWWW
W  W   W    W  W        W W W WW W W  OW
W W  WWWW        W   W WWW  W WS   W   W
WW   W                  W  WW W    W   W
W  WW W     WW  WW    W W W   WW   W   W
W  W  W W   WWWD W   WW   WW W  W  W W W
W      W   W   WW  WWW  W  W    W WW  WW
WWWWWWWWWWWWWWWWWWWWWWWWWWWWWWWWWWWWWWWW
