WWWWWWWWWWWWWWWWWWWWWWWWWWWWWWWWWWWWWWWW
WUW     WWW  W   W WW W   B     WWWW  WW
W  W   WWW  WWW  W     W WWW  W       WW
W  W   W WWW        W  W WW      W  W  W
W    E   WW     WW WW  W      W    W   W
W W         W W    WW W   WW   WWWW W  W
W  WW     WW W  WW W   WWO        W  W W
W  WW WW   WW W W    WW  WW   WWW      W
WW W   W WW       WW W  W  W    W  W   W
W      W   W  W WW   W  WW HW W       WW
W        W  W  W    W WW  WWWW  WWW   WW
WW WWW WW W   WW     W    W   WW      WW
W  W    W WW   W W  W WWW W  W WW W   WW
W W W   WWW    WW  W     WWW W   W  W  W
W     W WWWW W   WW   W  W W  W W WWW WW
W WWW W  W     W  W W WW W   W  W     WW
WWW W     W W W  SW   W WW   W   W     W
W   W W W   W W     W WW       WWWWWWW W
W WW    W W  W  WW WWWWW W  W WWW  W W W
W      W W      W W W   WW  W WW W WW WW
WWWW  W W W W   W W   W WW WW WWWW  W  W
W   WWW     WW WW   W  W      WWWWW  W W
W W  W  W    WW WW W   W  WWWW  W W  W W
WWW    WW       W  W W      W  WW WWW  W
WW    WW  WW  WW  W WW  WW   W  W W  WWW
WW WW    WWW WW WWW W    WW W     WW   W
W    W   W     W  W W  W W W   WWW WW  W
W  W W W   WW WWWWWWW W WW     W     W W
W W WWW  W  W       WWWW   W    W      W
WW   WW  W WW  W  W     W WW    WWW   WW
W    W WW WW WWW W  W WW  WW WWWW  WW WW
WWWW W   W  W  W    W WWW  W W W W     W
W      WW    WWW    WWWW  WW W         W
W W    WWW  WW   WW   W  WW        W   W
WWW WW   W W  W    WW  WW WWW W W W    W
W W  WWWW     DW   W   W  W     W W WW W
WW W W    W    W WWW       W  WW WW  WWW
WWWWW W W W        W W WWW W    WWW    W
W   W W W      W W         WWWW W   WW W
WWWWWWWWWWWWWWWWWWWWWWWWWWWWWWWWWWWWWWWW
