WWWWWWWWWWWWWWWWWWWWWWWWWWWWWWWWWWWWWWWW
WU W  W WW        W          W    W W  W
W W W W W WW  W WWW  W     W W     W W W
WWW   WWW      W   W  W   W   W W  W   W
W         WW      W     WW      W    W W
WW    W   WW  W WW   W W W     W W W   W
W  W W    W WW     WW  W    WW W  W    W
W   WW W  W       WWWWWW   W W      W  W
W     W   W      W  WW       W W W W  WW
WWWWWWW    W     W WW      W   W     W W
W W     W WW W  WWW   W     W  WWW    WW
W W  WW    WWW    W   W WW  WWW  WW  W W
W WW WW     WW W WW WW  W WW W W   WW  W
W    WW   W  W  SWD   W WW     WW W   WW
W   W W  WW OWWW       W        WW W   W
WW W        WW   W   WW  W W W   WW    W
W   W W WW   W      WW  W W W WWW      W
WW W  WW      W   W    WW WW        WW W
W   WBW W W W W W W W      W    W W    W
W   W  W W  W  WWW   W   W   W   W W   W
W      WWWW  W  WW  WW  W  W  W    W   W
WWW   W W  W     WW W   W W W        W W
W   W W  W  W W    W W W W   W W  W    W
W          W W    WW WW W WWW     WW  WW
WW   W WW    W  W W W  WW WW   WW     WW
W    W  W    WW      W   W WW W W   W  W
W WWW    W      W WWWW W  WW   W WW    W
W      W   W  W W  W   W    W W  WWW   W
W       WWWW   WWW   W     WW       W  W
W    W  WW     W  W    WWWW WW HWW W WWW
W       W W W  W W     WWW W W  WW  WW W
W W  W   W   WW   W              W   W W
W  W    EW   WW  W    W W W  W  W     WW
W  WW   W     W    WW   WW   W   W   WWW
WWWW W  W  WW W W        W  W  W       W
W WWWW       WW W      WWW      WW     W
W  WW W       WW   W W     W WW   WW W W
WW  W W WW  W WW  W W    WWW  W WW W   W
WW  W    WWW   W  WW    W  W       W W W
WWWWWWWWWWWWWWWWWWWWWWWWWWWWWWWWWWWWWWWW
