WWWWWWWWWWWWWWWWWWWWWWWWWWWWWWWWWWWWWWWW
WU   WW WW W W        W     W  W W W WWW
W   W  WWW  W    WW  W WW      W     WWW
WW   W W WW    WWW WWWW  W WWWW W      W
W W    W WW W WW  W W   W W  WW E W W WW
W  WW WW   W    W   W W WWW  WWW  WWW  W
W  W     WW   WW    W W      W  WWW  WWW
W  WW WW  WW  WW WW WW  WW   WW  W W WWW
W    WWWWW    WW   W       W W   W W W W
WW  WW         W W  WW           W     W
W WWW W WW        WW WWWW    W   W WW WW
WWW WW      WWW  W  W WWWWW    WW WWW  W
W WW WWW  WWW  W  W W WW   W W WW W    W
W W    WW  W     WWWWWW W  WW  WW W W  W
W WW  WWW      WW W WWW W     WW   W WWW
WWWW          W  W WW W WW        WW   W
WWW     W W WWW WW W W     WWW WW    W W
WW W     WW    W   W W    WW WW  W    WW
WW  W   WWW W WW  W W W W    W    W  WWW
W  W     WW     W  W  D   WW  W WWWWWWWW
WW    WWW WWW    W W    WWWWW    WW  WWW
W   W  WWW   WW   WWW  WWW W    W   W WW
WW     W  W  W       WWW   WW   W    W W
WW   W W   WWWWW  W  W     W  W W     WW
WW W       W   WWW      WW   WWW W W W W
WW    WWWWWW WW W      WWW  W      W WWW
W  W     W W         W W      WW  W W  W
WW   W  WWW  W WW WW WW  BW  WW      WWW
W  W    W W    W W  W    W   WW WW    WW
WW   W  WW  WWWWWW       W  W     W  WWW
WW W  W W W   W W W       WW    W     WW
WW  W  W W W   W         WW        W  WW
W W          WW W    WW WW      W W  WWW
W  W   WW W WW W W  WW     W    W  WS WW
W W W       WW WW WW  W  W  W   WW  W WW
W WWW OW    W   WWW W  W WW W  WW WWW  W
W WHW WW         W W WW  WW W WW      WW
W     W WWW  W  W   WWW  WW   WWW      W
W   WW   W   W   W  W  WW   W        W W
WWWWWWWWWWWWWWWWWWWWWWWWWWWWWWWWWWWWWWWW
