WWWWWWWWWWWWWWWWWWWWWWWWWWWWWWWWWWWWWWWW
WU   W  WW   W        W  W          WW W
W     W          W W  W   W WWW WW W   W
W  W W   W       W W  WW   WW W     W WW
W   W  WWWW  WW          W  W  EW WW   W
W W  W W  WWW   W  W     WW      W    WW
W W W  W       WW  W   W  WW     W   W W
WW        WW WW  W  W  WW     W  W W  WW
W    W  W   WWW  W  WW   W   W W       W
WW    W W   W W  W WW  W   W WW    WW  W
W  W  WWW WW W  W W W    W WW W        W
W   WWWW   W  W  W W   WW    WW  W    WW
W     W W        W   W   W      W  W W W
W  WW   WW W      WWW WW W W   WWW  W  W
W  W W WWWW                 W W        W
W   W    W        W W W WW W WWWW  W  WW
W    W   WW  W W       WWW   W  W    W W
WO   W   W W WW           WW     WWWWWWW
W W  W  W        W     W   W  W W      W
W W W W WW    HW    WW  WW WW   W  WW  W
WW WW    W     W    WWW WWW          S W
W          WW    WW    W W WW WW W     W
W   W  W  W  WW W  WWW W   W   W   W   W
W WW    WW  W       W   W   W    W  W  W
W    WW WWW W   W     WW W    W WW     W
W W  W    WW W W WW  WW                W
WW W W      W        W W   WWW    WW   W
W WW WW     W   W W    W W W W  WWW    W
W  WWW W  W   W       W   WW   WWW    WW
WW  W  W  W  W W W WWWW         W W W  W
W W   W  W   WW   W W W       W   W  W W
W WW W   W  W WWW   W WWW W W WWWW  WW W
WWW  WW   WW     W WWW W  W WW  W   W  W
W W  W  WW    DWWW  WW   WW       WWW WW
W      BW      W  W     WWWW W   W   WWW
W WWW W    WW    W  W W    W W    W    W
WWW     W        WW  W W W     W  W  W W
W    W   WW     W WW W WW    W    W W  W
WWW WW   WW         WW     W    W W W  W
WWWWWWWWWWWWWWWWWWWWWWWWWWWWWWWWWWWWWWWW
