WWWWWWWWWWWWWWWWWW
   WWWW  B O     W
W  WWWW  WWWWWW  W
W      WW      B W
W  WWB     WWWW  W
WWWWWDWWWK     WWW
W    BWWW  WW    W
W  WWWW    HWWW  W
W      +WWW     UW
WWWWWWWWWWWWWWWWWW
