WWWWWWWWWWWW
W S        W
W    K     W
WWWWW   W  W
W       W  W
W       W  W
W G W   WG W
W   W   D GW
W   W   WPWW
WU  W      W
W   O      W
W   WWW    W
W       KK  
W   G      W
WWWWWWWWWWWW